{
  "休": "⿰亻木",
  "好": "⿰女子",
  "明": "⿰日月",
  "林": "⿰木木",
  "森": "⿱木⿰木木",
  "想": "⿱相心",
  "愛": "⿱爫⿱冖⿰夂心",
  "爱": "⿱爫友",
  "學": "⿱⿰⿱臼冖子冖",
  "学": "⿱⿻丬冖子",
  "話": "⿰言舌",
  "语": "⿰讠吾",
  "語": "⿰言吾",
  "说": "⿰讠兑",
  "說": "⿰言兑",
  "聽": "⿰耳⿱壬⿰⿻十罒心",
  "听": "⿰口斤",
  "讀": "⿰言賣",
  "读": "⿰讠卖",
  "寫": "⿱宀⿰写⿺乚丶",
  "写": "⿱冖与",
  "看": "⿸手目",
  "見": "⿱目儿",
  "见": "⿱冂儿",
  "吃": "⿰口乞",
  "喝": "⿰口曷",
  "做": "⿰亻故",
  "買": "⿱罒貝",
  "买": "⿱⺈头",
  "賣": "⿱十買",
  "卖": "⿱十买",
  "價": "⿰亻賈",
  "价": "⿰亻介",
  "錢": "⿰金戔",
  "钱": "⿰钅戋",
  "開": "⿵門开",
  "开": "⿻一廾",
  "關": "⿵門⿱丷幺",
  "关": "⿱丷天",
  "電": "⿱雨电",
  "电": "⿻日乚",
  "腦": "⿰月⿱⺈⿻凶⿰丿丨",
  "脑": "⿰月⿱⺈凶",
  "手": "⿻丿⿱一⿰二丿",
  "機": "⿰木幾",
  "机": "⿰木几",
  "車": "⿻田一",
  "车": "⿻一日",
  "鳥": "⿹⿱丿㇀⿻日灬",
  "鸟": "⿹⿱丿㇀一",
  "魚": "⿱⿻田丨灬",
  "鱼": "⿱𠂊⿻田一",
  "新": "⿰亲斤",
  "舊": "⿱⿰臼⿱一隹冖",
  "旧": "⿻日丨",
  "大": "⿻一人",
  "小": "⿻亅八",
  "中": "⿻口丨",
  "上": "⿱⺊一",
  "下": "⿱一卜",
  "左": "⿸𠂇工",
  "右": "⿸𠂇口",
  "東": "⿻束日",
  "东": "⿱一小",
  "西": "⿻一⿴囗儿",
  "南": "⿱十⿵冂⿰⿳丨一丨⿳丨一丨",
  "北": "⿰⿸丿匕⿹匕丿",
  "家": "⿱宀豕",
  "國": "⿴囗或",
  "国": "⿴囗玉",
  "人": "⿰丿㇏",
  "女": "⿻女丶",
  "子": "⿻了一",
  "日": "⿴囗一",
  "月": "⿵冂⿰丨丨",
  "木": "⿻十⿰丿㇏",
  "水": "⿻亅⿰⿰丿丶⿰丿㇏",
  "火": "⿱⿰丿丶人",
  "土": "⿱十一",
  "金": "⿱人⿻王丷",
  "山": "⿻凵丨",
  "石": "⿸厂口",
  "田": "⿴囗十",
  "心": "⿻⿰丿㇏⿰丶丶丶"
}
